abcdef -> abcdfe
abcdfe -> abcedf
abcedf -> abcefd
abcefd -> abcfde
abcfde -> abcfed
abcfed -> abdcef
abdcef -> abdcfe
abdcfe -> abdecf
abdecf -> abdefc
abdefc -> abdfce
abdfce -> abdfec
abdfec -> abecdf
abecdf -> abecfd
abecfd -> abedcf
abedcf -> abedfc
abedfc -> abefcd
abefcd -> abefdc
abefdc -> abfcde
abfcde -> abfced
abfced -> abfdce
abfdce -> abfdec
abfdec -> abfecd
abfecd -> abfedc
abfedc -> acbdef
acbdef -> acbdfe
acbdfe -> acbedf
acbedf -> acbefd
acbefd -> acbfde
acbfde -> acbfed
acbfed -> acdbef
acdbef -> acdbfe
acdbfe -> acdebf
acdebf -> acdefb
acdefb -> acdfbe
acdfbe -> acdfeb
acdfeb -> acebdf
acebdf -> acebfd
acebfd -> acedbf
acedbf -> acedfb
acedfb -> acefbd
acefbd -> acefdb
acefdb -> acfbde
acfbde -> acfbed
acfbed -> acfdbe
acfdbe -> acfdeb
acfdeb -> acfebd
acfebd -> acfedb
acfedb -> adbcef
adbcef -> adbcfe
adbcfe -> adbecf
adbecf -> adbefc
adbefc -> adbfce
adbfce -> adbfec
adbfec -> adcbef
adcbef -> adcbfe
adcbfe -> adcebf
adcebf -> adcefb
adcefb -> adcfbe
adcfbe -> adcfeb
adcfeb -> adebcf
adebcf -> adebfc
adebfc -> adecbf
adecbf -> adecfb
adecfb -> adefbc
adefbc -> adefcb
adefcb -> adfbce
adfbce -> adfbec
adfbec -> adfcbe
adfcbe -> adfceb
adfceb -> adfebc
adfebc -> adfecb
adfecb -> aebcdf
aebcdf -> aebcfd
aebcfd -> aebdcf
aebdcf -> aebdfc
aebdfc -> aebfcd
aebfcd -> aebfdc
aebfdc -> aecbdf
aecbdf -> aecbfd
aecbfd -> aecdbf
aecdbf -> aecdfb
aecdfb -> aecfbd
aecfbd -> aecfdb
aecfdb -> aedbcf
aedbcf -> aedbfc
aedbfc -> aedcbf
aedcbf -> aedcfb
aedcfb -> aedfbc
aedfbc -> aedfcb
aedfcb -> aefbcd
aefbcd -> aefbdc
aefbdc -> aefcbd
aefcbd -> aefcdb
aefcdb -> aefdbc
aefdbc -> aefdcb
aefdcb -> afbcde
afbcde -> afbced
afbced -> afbdce
afbdce -> afbdec
afbdec -> afbecd
afbecd -> afbedc
afbedc -> afcbde
afcbde -> afcbed
afcbed -> afcdbe
afcdbe -> afcdeb
afcdeb -> afcebd
afcebd -> afcedb
afcedb -> afdbce
afdbce -> afdbec
afdbec -> afdcbe
afdcbe -> afdceb
afdceb -> afdebc
afdebc -> afdecb
afdecb -> afebcd
afebcd -> afebdc
afebdc -> afecbd
afecbd -> afecdb
afecdb -> afedbc
afedbc -> afedcb
afedcb -> bacdef
bacdef -> bacdfe
bacdfe -> bacedf
bacedf -> bacefd
bacefd -> bacfde
bacfde -> bacfed
bacfed -> badcef
badcef -> badcfe
badcfe -> badecf
badecf -> badefc
badefc -> badfce
badfce -> badfec
badfec -> baecdf
baecdf -> baecfd
baecfd -> baedcf
baedcf -> baedfc
baedfc -> baefcd
baefcd -> baefdc
baefdc -> bafcde
bafcde -> bafced
bafced -> bafdce
bafdce -> bafdec
bafdec -> bafecd
bafecd -> bafedc
bafedc -> bcadef
bcadef -> bcadfe
bcadfe -> bcaedf
bcaedf -> bcaefd
bcaefd -> bcafde
bcafde -> bcafed
bcafed -> bcdaef
bcdaef -> bcdafe
bcdafe -> bcdeaf
bcdeaf -> bcdefa
bcdefa -> bcdfae
bcdfae -> bcdfea
bcdfea -> bceadf
bceadf -> bceafd
bceafd -> bcedaf
bcedaf -> bcedfa
bcedfa -> bcefad
bcefad -> bcefda
bcefda -> bcfade
bcfade -> bcfaed
bcfaed -> bcfdae
bcfdae -> bcfdea
bcfdea -> bcfead
bcfead -> bcfeda
bcfeda -> bdacef
bdacef -> bdacfe
bdacfe -> bdaecf
bdaecf -> bdaefc
bdaefc -> bdafce
bdafce -> bdafec
bdafec -> bdcaef
bdcaef -> bdcafe
bdcafe -> bdceaf
bdceaf -> bdcefa
bdcefa -> bdcfae
bdcfae -> bdcfea
bdcfea -> bdeacf
bdeacf -> bdeafc
bdeafc -> bdecaf
bdecaf -> bdecfa
bdecfa -> bdefac
bdefac -> bdefca
bdefca -> bdface
bdface -> bdfaec
bdfaec -> bdfcae
bdfcae -> bdfcea
bdfcea -> bdfeac
bdfeac -> bdfeca
bdfeca -> beacdf
beacdf -> beacfd
beacfd -> beadcf
beadcf -> beadfc
beadfc -> beafcd
beafcd -> beafdc
beafdc -> becadf
becadf -> becafd
becafd -> becdaf
becdaf -> becdfa
becdfa -> becfad
becfad -> becfda
becfda -> bedacf
bedacf -> bedafc
bedafc -> bedcaf
bedcaf -> bedcfa
bedcfa -> bedfac
bedfac -> bedfca
bedfca -> befacd
befacd -> befadc
befadc -> befcad
befcad -> befcda
befcda -> befdac
befdac -> befdca
befdca -> bfacde
bfacde -> bfaced
bfaced -> bfadce
bfadce -> bfadec
bfadec -> bfaecd
bfaecd -> bfaedc
bfaedc -> bfcade
bfcade -> bfcaed
bfcaed -> bfcdae
bfcdae -> bfcdea
bfcdea -> bfcead
bfcead -> bfceda
bfceda -> bfdace
bfdace -> bfdaec
bfdaec -> bfdcae
bfdcae -> bfdcea
bfdcea -> bfdeac
bfdeac -> bfdeca
bfdeca -> bfeacd
bfeacd -> bfeadc
bfeadc -> bfecad
bfecad -> bfecda
bfecda -> bfedac
bfedac -> bfedca
bfedca -> cabdef
cabdef -> cabdfe
cabdfe -> cabedf
cabedf -> cabefd
cabefd -> cabfde
cabfde -> cabfed
cabfed -> cadbef
cadbef -> cadbfe
cadbfe -> cadebf
cadebf -> cadefb
cadefb -> cadfbe
cadfbe -> cadfeb
cadfeb -> caebdf
caebdf -> caebfd
caebfd -> caedbf
caedbf -> caedfb
caedfb -> caefbd
caefbd -> caefdb
caefdb -> cafbde
cafbde -> cafbed
cafbed -> cafdbe
cafdbe -> cafdeb
cafdeb -> cafebd
cafebd -> cafedb
cafedb -> cbadef
cbadef -> cbadfe
cbadfe -> cbaedf
cbaedf -> cbaefd
cbaefd -> cbafde
cbafde -> cbafed
cbafed -> cbdaef
cbdaef -> cbdafe
cbdafe -> cbdeaf
cbdeaf -> cbdefa
cbdefa -> cbdfae
cbdfae -> cbdfea
cbdfea -> cbeadf
cbeadf -> cbeafd
cbeafd -> cbedaf
cbedaf -> cbedfa
cbedfa -> cbefad
cbefad -> cbefda
cbefda -> cbfade
cbfade -> cbfaed
cbfaed -> cbfdae
cbfdae -> cbfdea
cbfdea -> cbfead
cbfead -> cbfeda
cbfeda -> cdabef
cdabef -> cdabfe
cdabfe -> cdaebf
cdaebf -> cdaefb
cdaefb -> cdafbe
cdafbe -> cdafeb
cdafeb -> cdbaef
cdbaef -> cdbafe
cdbafe -> cdbeaf
cdbeaf -> cdbefa
cdbefa -> cdbfae
cdbfae -> cdbfea
cdbfea -> cdeabf
cdeabf -> cdeafb
cdeafb -> cdebaf
cdebaf -> cdebfa
cdebfa -> cdefab
cdefab -> cdefba
cdefba -> cdfabe
cdfabe -> cdfaeb
cdfaeb -> cdfbae
cdfbae -> cdfbea
cdfbea -> cdfeab
cdfeab -> cdfeba
cdfeba -> ceabdf
ceabdf -> ceabfd
ceabfd -> ceadbf
ceadbf -> ceadfb
ceadfb -> ceafbd
ceafbd -> ceafdb
ceafdb -> cebadf
cebadf -> cebafd
cebafd -> cebdaf
cebdaf -> cebdfa
cebdfa -> cebfad
cebfad -> cebfda
cebfda -> cedabf
cedabf -> cedafb
cedafb -> cedbaf
cedbaf -> cedbfa
cedbfa -> cedfab
cedfab -> cedfba
cedfba -> cefabd
cefabd -> cefadb
cefadb -> cefbad
cefbad -> cefbda
cefbda -> cefdab
cefdab -> cefdba
cefdba -> cfabde
cfabde -> cfabed
cfabed -> cfadbe
cfadbe -> cfadeb
cfadeb -> cfaebd
cfaebd -> cfaedb
cfaedb -> cfbade
cfbade -> cfbaed
cfbaed -> cfbdae
cfbdae -> cfbdea
cfbdea -> cfbead
cfbead -> cfbeda
cfbeda -> cfdabe
cfdabe -> cfdaeb
cfdaeb -> cfdbae
cfdbae -> cfdbea
cfdbea -> cfdeab
cfdeab -> cfdeba
cfdeba -> cfeabd
cfeabd -> cfeadb
cfeadb -> cfebad
cfebad -> cfebda
cfebda -> cfedab
cfedab -> cfedba
cfedba -> dabcef
dabcef -> dabcfe
dabcfe -> dabecf
dabecf -> dabefc
dabefc -> dabfce
dabfce -> dabfec
dabfec -> dacbef
dacbef -> dacbfe
dacbfe -> dacebf
dacebf -> dacefb
dacefb -> dacfbe
dacfbe -> dacfeb
dacfeb -> daebcf
daebcf -> daebfc
daebfc -> daecbf
daecbf -> daecfb
daecfb -> daefbc
daefbc -> daefcb
daefcb -> dafbce
dafbce -> dafbec
dafbec -> dafcbe
dafcbe -> dafceb
dafceb -> dafebc
dafebc -> dafecb
dafecb -> dbacef
dbacef -> dbacfe
dbacfe -> dbaecf
dbaecf -> dbaefc
dbaefc -> dbafce
dbafce -> dbafec
dbafec -> dbcaef
dbcaef -> dbcafe
dbcafe -> dbceaf
dbceaf -> dbcefa
dbcefa -> dbcfae
dbcfae -> dbcfea
dbcfea -> dbeacf
dbeacf -> dbeafc
dbeafc -> dbecaf
dbecaf -> dbecfa
dbecfa -> dbefac
dbefac -> dbefca
dbefca -> dbface
dbface -> dbfaec
dbfaec -> dbfcae
dbfcae -> dbfcea
dbfcea -> dbfeac
dbfeac -> dbfeca
dbfeca -> dcabef
dcabef -> dcabfe
dcabfe -> dcaebf
dcaebf -> dcaefb
dcaefb -> dcafbe
dcafbe -> dcafeb
dcafeb -> dcbaef
dcbaef -> dcbafe
dcbafe -> dcbeaf
dcbeaf -> dcbefa
dcbefa -> dcbfae
dcbfae -> dcbfea
dcbfea -> dceabf
dceabf -> dceafb
dceafb -> dcebaf
dcebaf -> dcebfa
dcebfa -> dcefab
dcefab -> dcefba
dcefba -> dcfabe
dcfabe -> dcfaeb
dcfaeb -> dcfbae
dcfbae -> dcfbea
dcfbea -> dcfeab
dcfeab -> dcfeba
dcfeba -> deabcf
deabcf -> deabfc
deabfc -> deacbf
deacbf -> deacfb
deacfb -> deafbc
deafbc -> deafcb
deafcb -> debacf
debacf -> debafc
debafc -> debcaf
debcaf -> debcfa
debcfa -> debfac
debfac -> debfca
debfca -> decabf
decabf -> decafb
decafb -> decbaf
decbaf -> decbfa
decbfa -> decfab
decfab -> decfba
decfba -> defabc
defabc -> defacb
defacb -> defbac
defbac -> defbca
defbca -> defcab
defcab -> defcba
defcba -> dfabce
dfabce -> dfabec
dfabec -> dfacbe
dfacbe -> dfaceb
dfaceb -> dfaebc
dfaebc -> dfaecb
dfaecb -> dfbace
dfbace -> dfbaec
dfbaec -> dfbcae
dfbcae -> dfbcea
dfbcea -> dfbeac
dfbeac -> dfbeca
dfbeca -> dfcabe
dfcabe -> dfcaeb
dfcaeb -> dfcbae
dfcbae -> dfcbea
dfcbea -> dfceab
dfceab -> dfceba
dfceba -> dfeabc
dfeabc -> dfeacb
dfeacb -> dfebac
dfebac -> dfebca
dfebca -> dfecab
dfecab -> dfecba
dfecba -> eabcdf
eabcdf -> eabcfd
eabcfd -> eabdcf
eabdcf -> eabdfc
eabdfc -> eabfcd
eabfcd -> eabfdc
eabfdc -> eacbdf
eacbdf -> eacbfd
eacbfd -> eacdbf
eacdbf -> eacdfb
eacdfb -> eacfbd
eacfbd -> eacfdb
eacfdb -> eadbcf
eadbcf -> eadbfc
eadbfc -> eadcbf
eadcbf -> eadcfb
eadcfb -> eadfbc
eadfbc -> eadfcb
eadfcb -> eafbcd
eafbcd -> eafbdc
eafbdc -> eafcbd
eafcbd -> eafcdb
eafcdb -> eafdbc
eafdbc -> eafdcb
eafdcb -> ebacdf
ebacdf -> ebacfd
ebacfd -> ebadcf
ebadcf -> ebadfc
ebadfc -> ebafcd
ebafcd -> ebafdc
ebafdc -> ebcadf
ebcadf -> ebcafd
ebcafd -> ebcdaf
ebcdaf -> ebcdfa
ebcdfa -> ebcfad
ebcfad -> ebcfda
ebcfda -> ebdacf
ebdacf -> ebdafc
ebdafc -> ebdcaf
ebdcaf -> ebdcfa
ebdcfa -> ebdfac
ebdfac -> ebdfca
ebdfca -> ebfacd
ebfacd -> ebfadc
ebfadc -> ebfcad
ebfcad -> ebfcda
ebfcda -> ebfdac
ebfdac -> ebfdca
ebfdca -> ecabdf
ecabdf -> ecabfd
ecabfd -> ecadbf
ecadbf -> ecadfb
ecadfb -> ecafbd
ecafbd -> ecafdb
ecafdb -> ecbadf
ecbadf -> ecbafd
ecbafd -> ecbdaf
ecbdaf -> ecbdfa
ecbdfa -> ecbfad
ecbfad -> ecbfda
ecbfda -> ecdabf
ecdabf -> ecdafb
ecdafb -> ecdbaf
ecdbaf -> ecdbfa
ecdbfa -> ecdfab
ecdfab -> ecdfba
ecdfba -> ecfabd
ecfabd -> ecfadb
ecfadb -> ecfbad
ecfbad -> ecfbda
ecfbda -> ecfdab
ecfdab -> ecfdba
ecfdba -> edabcf
edabcf -> edabfc
edabfc -> edacbf
edacbf -> edacfb
edacfb -> edafbc
edafbc -> edafcb
edafcb -> edbacf
edbacf -> edbafc
edbafc -> edbcaf
edbcaf -> edbcfa
edbcfa -> edbfac
edbfac -> edbfca
edbfca -> edcabf
edcabf -> edcafb
edcafb -> edcbaf
edcbaf -> edcbfa
edcbfa -> edcfab
edcfab -> edcfba
edcfba -> edfabc
edfabc -> edfacb
edfacb -> edfbac
edfbac -> edfbca
edfbca -> edfcab
edfcab -> edfcba
edfcba -> efabcd
efabcd -> efabdc
efabdc -> efacbd
efacbd -> efacdb
efacdb -> efadbc
efadbc -> efadcb
efadcb -> efbacd
efbacd -> efbadc
efbadc -> efbcad
efbcad -> efbcda
efbcda -> efbdac
efbdac -> efbdca
efbdca -> efcabd
efcabd -> efcadb
efcadb -> efcbad
efcbad -> efcbda
efcbda -> efcdab
efcdab -> efcdba
efcdba -> efdabc
efdabc -> efdacb
efdacb -> efdbac
efdbac -> efdbca
efdbca -> efdcab
efdcab -> efdcba
efdcba -> fabcde
fabcde -> fabced
fabced -> fabdce
fabdce -> fabdec
fabdec -> fabecd
fabecd -> fabedc
fabedc -> facbde
facbde -> facbed
facbed -> facdbe
facdbe -> facdeb
facdeb -> facebd
facebd -> facedb
facedb -> fadbce
fadbce -> fadbec
fadbec -> fadcbe
fadcbe -> fadceb
fadceb -> fadebc
fadebc -> fadecb
fadecb -> faebcd
faebcd -> faebdc
faebdc -> faecbd
faecbd -> faecdb
faecdb -> faedbc
faedbc -> faedcb
faedcb -> fbacde
fbacde -> fbaced
fbaced -> fbadce
fbadce -> fbadec
fbadec -> fbaecd
fbaecd -> fbaedc
fbaedc -> fbcade
fbcade -> fbcaed
fbcaed -> fbcdae
fbcdae -> fbcdea
fbcdea -> fbcead
fbcead -> fbceda
fbceda -> fbdace
fbdace -> fbdaec
fbdaec -> fbdcae
fbdcae -> fbdcea
fbdcea -> fbdeac
fbdeac -> fbdeca
fbdeca -> fbeacd
fbeacd -> fbeadc
fbeadc -> fbecad
fbecad -> fbecda
fbecda -> fbedac
fbedac -> fbedca
fbedca -> fcabde
fcabde -> fcabed
fcabed -> fcadbe
fcadbe -> fcadeb
fcadeb -> fcaebd
fcaebd -> fcaedb
fcaedb -> fcbade
fcbade -> fcbaed
fcbaed -> fcbdae
fcbdae -> fcbdea
fcbdea -> fcbead
fcbead -> fcbeda
fcbeda -> fcdabe
fcdabe -> fcdaeb
fcdaeb -> fcdbae
fcdbae -> fcdbea
fcdbea -> fcdeab
fcdeab -> fcdeba
fcdeba -> fceabd
fceabd -> fceadb
fceadb -> fcebad
fcebad -> fcebda
fcebda -> fcedab
fcedab -> fcedba
fcedba -> fdabce
fdabce -> fdabec
fdabec -> fdacbe
fdacbe -> fdaceb
fdaceb -> fdaebc
fdaebc -> fdaecb
fdaecb -> fdbace
fdbace -> fdbaec
fdbaec -> fdbcae
fdbcae -> fdbcea
fdbcea -> fdbeac
fdbeac -> fdbeca
fdbeca -> fdcabe
fdcabe -> fdcaeb
fdcaeb -> fdcbae
fdcbae -> fdcbea
fdcbea -> fdceab
fdceab -> fdceba
fdceba -> fdeabc
fdeabc -> fdeacb
fdeacb -> fdebac
fdebac -> fdebca
fdebca -> fdecab
fdecab -> fdecba
fdecba -> feabcd
feabcd -> feabdc
feabdc -> feacbd
feacbd -> feacdb
feacdb -> feadbc
feadbc -> feadcb
feadcb -> febacd
febacd -> febadc
febadc -> febcad
febcad -> febcda
febcda -> febdac
febdac -> febdca
febdca -> fecabd
fecabd -> fecadb
fecadb -> fecbad
fecbad -> fecbda
fecbda -> fecdab
fecdab -> fecdba
fecdba -> fedabc
fedabc -> fedacb
fedacb -> fedbac
fedbac -> fedbca
fedbca -> fedcab
fedcab -> fedcba
